0x0013	0x0014	0x0015	0x0101	0x0101	0x0101	0x0101	0x0101	0x0101	0x0101	0x0101	0x0101	0x0101	0x0101	0x0101
0x1113	0x1114	0x1114	0x0015	0x0101	0x0101	0x0101	0x0101	0x0101	0x0101	0x0101	0x0101	0x0101	0x0101	0x0101
0x1213	0x1114	0x1114	0x1114	0x0015	0x0101	0x0101	0x0101	0x0101	0x0101	0x0101	0x0101	0x0101	0x0101	0x0101
0x0101	0x1113	0x1114	0x1114	0x1114	0x0015	0x0101	0x0101	0x0101	0x0101	0x0101	0x0101	0x0101	0x0101	0x0101
0x0101	0x1213	0x1214	0x1214	0x1214	0x1215	0x0101	0x0101	0x0101	0x0101	0x0101	0x0101	0x0101	0x0101	0x0101
0x0101	0x0101	0x0101	0x0101	0x0101	0x0101	0x0101	0x0101	0x0101	0x0101	0x0101	0x0101	0x0101	0x0101	0x0101
0x0101	0x0101	0x0101	0x0101	0x0101	0x0101	0x0101	0x0101	0x0101	0x0101	0x0101	0x0101	0x0101	0x0101	0x0101
0x0101	0x0101	0x0101	0x0101	0x0101	0x0101	0x0101	0x0101	0x0101	0x0101	0x0101	0x0101	0x0101	0x0101	0x0101
0x0101	0x0101	0x0101	0x0101	0x0101	0x0101	0x0101	0x0101	0x0101	0x0101	0x0101	0x0101	0x0101	0x0101	0x0101
0x0101	0x0101	0x0101	0x0101	0x0101	0x0101	0x0101	0x0101	0x0101	0x0101	0x0101	0x0101	0x0101	0x0101	0x0101
0x0101	0x0101	0x0101	0x0101	0x0101	0x0101	0x0101	0x0101	0x0101	0x0101	0x0101	0x0101	0x0101	0x0101	0x0101
0x0101	0x0101	0x0101	0x0101	0x0101	0x0101	0x0101	0x0101	0x0101	0x0101	0x0101	0x0101	0x0101	0x0101	0x0101